Whiskey Sour: - 2 oz bourbon whiskey - 3/4 oz fresh lemon juice - 1/2 oz simple syrup - Garnish: Lemon wedge
Margarita: - 2 oz tequila - 1 oz lime juice - 1/2 oz triple sec - Garnish: Lime wheel
Martini: - 2 1/2 oz gin - 1/2 oz dry vermouth - Garnish: Olive or twist of lemon peel
Old Fashioned: - 2 oz bourbon whiskey - 1/2 oz simple syrup - 2 dashes Angostura bitters - Garnish: Orange slice and cherry
Negroni: - 1 oz gin - 1 oz sweet vermouth - 1 oz Campari - Garnish: Orange peel
Adios Motherfucker - Vodka, rum, tequila, gin, blue curacao, sweet and sour mix, Sprite
Alabama Slammer - Southern Comfort, amaretto, orange juice, cranberry juice
Americano - Campari, sweet vermouth, soda water
Aperol Spritz - Aperol, prosecco, soda water
Aviation - Gin, maraschino liqueur, crème de violette, lemon juice
Añejo Highball - Añejo rum, ginger beer, lime juice
Aperol Sunrise - Aperol, orange juice, grenadine
Apple Cider Margarita - Tequila, apple cider, lime juice, triple sec, apple slices (for garnish)
Apple Cider Mojito - White rum, apple cider, lime juice, mint leaves, club soda
Apple Ginger Smash - Bourbon, apple cider, ginger beer, lime juice, apple slices (for garnish)
Apple Pie on the Rocks - Cinnamon whiskey, apple cider, lemon juice, cinnamon sticks (for garnish)
Apple Toddy - Bourbon, apple cider, cinnamon sticks, cloves, lemon juice
Apricot Sour - Apricot brandy, lemon juice, simple syrup, egg white
Aqua Velva - Gin, blue curacao, lemon juice, cream of coconut
Arak and Grapefruit - Arak, grapefruit juice, simple syrup, club soda
Arnold Palmer Cocktail - Iced tea, lemonade, vodka
Asian Pear Mojito - Asian pear, lime juice, mint leaves, white rum, club soda
Atlantic Breeze - Vodka, grapefruit juice, cranberry juice, club soda
Attitude Adjustment - Gin, triple sec, lemon juice, cranberry juice, orange bitters
Autumn Apple Cider Sangria - Red wine, apple cider, apple brandy, apples, pears, oranges, cinnamon sticks
Autumn Spice Bourbon Cocktail - Bourbon, apple cider, cinnamon syrup, lemon juice
Avalanche - Vodka, amaretto, orange juice, cranberry juice
Azul Margarita - Tequila, blue curacao, lime juice, agave nectar, salt (for rimming)
Alcoholic Hot Chocolate - Hot chocolate, peppermint schnapps, whipped cream (optional)
Almond Joy Martini - Coconut rum, amaretto, crème de cacao, half-and-half
Amaretto Cranberry Kiss - Amaretto, cranberry juice, lemon juice, simple syrup
Amaretto Sour - Amaretto, lemon juice, simple syrup, egg white
Amber Dream - Spiced rum, apple cider, ginger ale, lime juice
Amber Moon - Vodka, cranberry juice, orange juice, grapefruit juice
Amelia - Gin, blackberry liqueur, lemon juice, simple syrup, blackberries (for garnish)
Amnesia - Blue curacao, vodka, lemon juice, Sprite
Angel Face - Gin, apricot brandy, Calvados
Angel’s Kiss - Brandy, crème de cacao, cream
Angel’s Share - Bourbon, grapefruit juice, honey syrup, lemon juice
Angel’s Tit - Vodka, orange juice, Red Bull
Antifreeze - Vodka, blue curacao, pineapple juice, lemon juice
Aphrodite's Martini - Vodka, raspberry liqueur, cranberry juice, lime juice, raspberries (for garnish)
Apple Martini - Vodka, apple schnapps, lemon juice, apple slices (for garnish)
Apple Brandy Sour - Apple brandy, lemon juice, simple syrup, Angostura bitters, cherry (for garnish)
Apple Cider Bellini - Apple cider, Prosecco, cinnamon sugar (for rimming)
Apple Cinnamon Margarita - Tequila, apple cider, lime juice, cinnamon syrup, apple slices (for garnish)
Apple Crisp Cocktail - Vodka, apple cider, lemon juice, honey, cinnamon sugar (for rimming)
Applejack Sour - Applejack brandy, lemon juice, simple syrup, egg white
Apricot Fizz - Apricot brandy, lemon juice, simple syrup, club soda
Apricot Martini - Vodka, apricot brandy, lime juice, simple syrup, apricot (for garnish)
Aquarius - Blue curacao, tequila, grapefruit juice, lime juice, agave nectar
Aranciata Fizz - Campari, orange juice, soda water, orange slice (for garnish)
Arctic Char Martini - Vodka, white cranberry juice, lime juice, honey, lavender bitters
Autumn Daiquiri - Rum, apple cider, lemon juice, maple syrup, cinnamon
Autumn Sunset - Gin, Aperol, grapefruit juice, lime juice, club soda
Bahama Mama - Dark rum (1 oz), coconut rum (1 oz), pineapple juice (2 oz), orange juice (2 oz), grenadine (1/2 oz)
Banana Daiquiri - Light rum (2 oz), banana liqueur (1 oz), lime juice (1 oz), simple syrup (1/2 oz), ice
Banana Margarita - Tequila (2 oz), triple sec (1 oz), banana liqueur (1 oz), lime juice (1 oz), ice
Basil Gin Smash - Gin (2 oz), fresh basil leaves (5-6), lemon juice (3/4 oz), simple syrup (3/4 oz), ice
Bay Breeze - Vodka (2 oz), cranberry juice (2 oz), pineapple juice (2 oz), ice
Bellini - Peach puree (2 oz), Prosecco (4 oz), peach slice (for garnish)
Between the Sheets - Brandy (1 oz), light rum (1 oz), triple sec (1 oz), lemon juice (1 oz)
Black Russian - Vodka (2 oz), coffee liqueur (1 oz), ice
Blackberry Bramble - Gin (2 oz), blackberry liqueur (1 oz), lemon juice (1 oz), simple syrup (1/2 oz), fresh blackberries (for garnish)
Blackberry Margarita - Tequila (2 oz), blackberry liqueur (1 oz), lime juice (1 oz), simple syrup (1 oz), fresh blackberries (for garnish)
Blackberry Whiskey Lemonade - Whiskey (1 1/2 oz), blackberry syrup (1 oz), lemon juice (1 oz), club soda (2 oz), fresh blackberries (for garnish)
Blood and Sand - Scotch (3/4 oz), sweet vermouth (3/4 oz), Cherry Heering (3/4 oz), orange juice (3/4 oz), orange peel (for garnish)
Blue Hawaiian - Light rum (1 oz), blue curaçao (1 oz), pineapple juice (3 oz), cream of coconut (1 oz), ice
Blue Lagoon - Vodka (1 1/2 oz), blue curaçao (1 oz), lemonade (3 oz), ice
Blue Margarita - Tequila (2 oz), blue curaçao (1 oz), lime juice (1 oz), ice
Bourbon Sour - Bourbon (2 oz), lemon juice (3/4 oz), simple syrup (1/2 oz), egg white (optional)
Bramble - Gin (2 oz), lemon juice (3/4 oz), simple syrup (1/2 oz), crème de mûre (1/2 oz), fresh blackberries (for garnish)
Breakfast Martini - Gin (2 oz), orange marmalade (1 tbsp), lemon juice (3/4 oz), Cointreau (1/2 oz), ice
Brown Derby - Bourbon (2 oz), grapefruit juice (1 oz), honey syrup (1/2 oz), grapefruit twist (for garnish)
Buttered Rum - Dark rum (2 oz), butter (1 tbsp), brown sugar (1 tbsp), cinnamon (1/2 tsp), nutmeg (1/2 tsp), hot water (6 oz)
Caramel Apple Martini - Vodka (2 oz), apple cider (2 oz), caramel syrup (1 oz), ice
Caribbean Rum Punch - Dark rum (2 oz), pineapple juice (2 oz), orange juice (2 oz), lime juice (1 oz), grenadine (1/2 oz), Angostura bitters (1-2 dashes)
Champagne Cocktail - Champagne (4 oz), sugar cube (1), Angostura bitters (2-3 dashes), lemon twist (for garnish)
Cherry Bomb - Cherry vodka (2 oz), Red Bull (6 oz), ice
Cherry Lime Rickey - Gin (2 oz), lime juice (1 oz), cherry syrup (1 oz), club soda (2 oz), lime wedge (for garnish)
Chocolate Martini - Vodka (2 oz), chocolate liqueur (1 oz), half-and-half (1 oz), chocolate shavings (for garnish)
Classic Margarita - Tequila (2 oz), triple sec (1 oz), lime juice (1 oz), salt (for rimming), lime wedge (for garnish)
Clover Club - Gin (2 oz), raspberry syrup (1 oz), lemon juice (3/4 oz), egg white (1), ice
Coco Loco - Rum (1 oz), vodka (1 oz), tequila (1 oz), coconut cream (1 oz), pineapple juice (2 oz), ice
Coconut Mojito - Rum (2 oz), coconut water (2 oz), coconut milk (2 oz), lime juice (1 oz), mint leaves (6-8), club soda (2 oz)
Cosmopolitan - Vodka (1 1/2 oz), triple sec (1 oz), cranberry juice (1 oz), lime juice (1/2 oz)
Cranberry Martini - Vodka (2 oz), cranberry juice (2 oz), lime juice (1 oz), simple syrup (1/2 oz), cranberries (for garnish)
Cuba Libre - Rum (2 oz), Coca-Cola (4 oz), lime juice (1 oz), lime wedge (for garnish)
Daiquiri - Rum (2 oz), lime juice (1 oz), simple syrup (1/2 oz), ice
Dark 'n' Stormy - Dark rum (2 oz), ginger beer (3 oz), lime juice (1/2 oz), lime wedge (for garnish)
Dirty Martini - Vodka (2 oz), dry vermouth (1/2 oz), olive brine (1/2 oz), green olives (for garnish)
Dreamy Winter - Vodka (2 oz), cinnamon schnapps (1 oz), apple cider (2 oz), whipped cream (1 oz), cinnamon stick (for garnish)
Drunken Sailor - Spiced rum (2 oz), apple cider (2 oz), ginger beer (2 oz), lime juice (1 oz), cinnamon stick (for garnish)
Duck Fart - Kahlúa (1 oz), Bailey's Irish Cream (1 oz), Crown Royal (1 oz), ice
Dutch Mule - Gin (2 oz), ginger beer (3 oz), lime juice (1 oz), lime wedge (for garnish)
Egg Nog - Bourbon (1 oz), spiced rum (1 oz), milk (4 oz), heavy cream (1 oz), simple syrup (1 oz), egg yolk (1), nutmeg (1/4 tsp)
Espresso Martini - Vodka (2 oz), Kahlúa (1 oz), espresso (1 oz), simple syrup (1/2 oz), coffee beans (for garnish)
French 75 - Gin (2 oz), lemon juice (1 oz), simple syrup (1/2 oz), Champagne (2 oz), lemon twist (for garnish)
French Connection - Cognac (2 oz), amaretto (1 oz), ice
Fuzzy Navel - Peach schnapps (1 1/2 oz), orange juice (4 oz), ice
Gingerbread Martini - Vodka (2 oz), ginger liqueur (1 oz), half-and-half (1 oz), simple syrup (1/2 oz), ginger snap cookie crumbs (for garnish)
Godfather - Scotch (2 oz), amaretto (1 oz), ice
Grapefruit Crush - Vodka (2 oz), grapefruit juice (3 oz), club soda (1 oz), simple syrup (1/2 oz), grapefruit wedge (for garnish)
Grasshopper - Crème de menthe (1 oz), crème de cacao (1 oz), cream (1 oz), ice
Greyhound - Vodka (2 oz), grapefruit juice (4 oz), ice